....................
....................
....................
..##############....
....................
...........#........
#########..#........
...........#.###.#..
....#####..#.###.#..
....#####..#.###.#..
....#####..#.###.#..
....#####........#..
.................#..
##################..
.................#..
.................#..
....#######......#..
....#######......#..
....##############..
....................