....................
....................
....................
..##############....
....................
....................
....................
.................#..
....#####........#..
....#####........#..
....#####........#..
....#####........#..
.................#..
.................#..
.................#..
.................#..
.................#..
.................#..
.................#..
....................