....................
....................
....................
..##############....
....................
...........#........
#########..#........
#########..#.###.#..
#########..#.###.#..
#########..#.###.#..
#########..#.###.#..
#########........#..
#########........#..
#########..#######..
.................#..
.................#..
....#######......#..
....#######......#..
....##############..
....................