.......##########...
.......#........#...
.......#........#...
#####..#........#...
....#...........#...
....#...........#...
#####..#........#...
.......#........#...
.......######.###...
#####..#........#...
....#..#........#...
....#..#........#...
....#..#........#...
#####..#........#...
.......#........#...
.......#........#...
#####..#######..##.#
....#..#............
....#..#............
....#..#............